NO textures/file.xpm
SO textures/file1.xpm
WE textures/file2.xpm
C 135,206,23
EA textures/file3.xpm
F 50,50,50

1111
1111
 111
111
101
1N1
111