NO textures/file.xpm
SO textures/file1.xpm
WE textures/file2.xpm
C 135,206,23
EA textures/file3.xpm
F      50    ,     50,     5

1111111111111111111111111111111111111111111
1111111111111111111111111110000000000000001
                          10000000000000001
                          11000000000000011
                          11100000000000111
                          11110000000001111
                          11111000000011111
                          11111100000111111
                          11111110001111111
                          11111111011111111
                          11111111011111111
                          11111111011111111
                          11100000000000111
                          11110000000001111
                          111110000N0011111
                          11111100000111111
                          11111110001111111
                          11111111011111111
                          11111111011111111
                          11111111111111111